11111111111111111111111111111
100000010000000100000000000C1
10C1000111111001C111111110001
11110001000100011100000011001
111100C1C10100000100011110011
11110111110000E0000011C000111
1C000001010111111100011100101
10100001C101C0P0C100000100101
101000010101C000C101111100101
10100101010111001101000000101
101001C0000000000001011111101
1010011111111111111101C000001
101C0000000001100000010111101
101111111111C1100000010010101
1011C000011111111111011110101
10111110011000000000000000101
1011000C111101001111111111101
10110011111101000000000111101
100000000000C100111111000CCC1
11111111111111111111111111111
